         1111111111111111111111111
         1000000000110000000000001
         101100000111000000000001
         100100000000000000000000111111111
1111111111011000001110000000000001
100000000011000001110111111111111
11110111111111011100000010001
11110111111011011101010010001   11111
11000000110101011100000010001   11011
1000W000000000001100000010001   11111
10000000000000001101010010001
11000111110101011111011110111
11110111 1110101 101111010001
11111111 1111111 111111111111

NO ./pics/colorstone.xpm
SO ./pics/bluestone.xpm
F 123,01,25

WE ./pics/mossy.xpm
EA ./pics/greystone.xpm

C 30,0,1

